#########################
#.......................#
#.######.#########..#####
#.......................#
#..#####..########....###
#...#..#..#.....###....##
#...................... #
#########################
